...#############
...............#
####..####..####
#.....#........#
#..##########..#
#.....#.....#..#
####..####..####
#.....#.....#..#
#..#######..#..#
#..............#
#############...
