...#######
......#..#
#..####..#
#..#..#..#
#..#..#..#
#........#
#######...